11111111111
1PCE00000C1
10000000001
10000000001
1C0000000C1
11111111111